XXXXX XXXXX XXXXX
X   X   X   X   X
X X X X   X X X X
X X   X X X   X X
XXXXX XXXXX XXXXX
