XXXXX XXXXXXXXX XXXXX
X     X   X   X     X
X XXX X X   X X XXX X
X   X   X X X   X   X
XXXXX XXXXXXXXX XXXXX
