XXXXX XXXXXXXXX XXXXX
X     X   X   X     X
X XXX X X X X X XXX X
X   X   X X X   X   X
XXXXX XXX   XXX XXXXX
X   X   X X X   X   X
X XXX X X X X X XXX X
X     X   X   X     X
XXXXX XXXXXXXXX XXXXX
