XXXXX XXXXX XXXXXXXXX XXXXX XXXXX
X       X       X       X       X
XXXXX X X X XXXXXXXXX X X X XXXXX
X     X   X           X   X     X
X XXXXX X XXXXX X XXXXX X XXXXX X
X       X       X       X       X
XXXXX XXXXX XXXXXXXXX XXXXX XXXXX
