XXXXX XXXXX XXXXXXXXX XXXXX XXXXX
X     X X X     X     X X X     X
X XXX X X X XXX X XXX X X X XXX X
X   X   X   X   X   X   X   X   X
XXX XXX   XXX X   X XXX   XXX XXX
X X   X X X   X X X   X X X   X X
X XXX X X X XXX X XXX X X X XXX X
X     X X X     X     X X X     X
XXXXX XXXXX XXXXXXXXX XXXXX XXXXX
X     X X X     X     X X X     X
X XXX X X X XXX X XXX X X X XXX X
X X   X X X   X X X   X X X   X X
XXX XXX   XXX X   X XXX   XXX XXX
X   X   X   X   X   X   X   X   X
X XXX X X X XXX X XXX X X X XXX X
X     X X X     X     X X X     X
XXXXX XXXXX XXXXXXXXX XXXXX XXXXX
